0 0 0 0 0 0 0 0 0 0 0 0 0 0 0 0 0 0 0 0 0 0 0 0 0 0 0 0 0 0 0 0 0 0 0 0 0 0 0 0 0 0 0 0 0 0 0 0 0 0 0 0 0 0 0 0 0 0 0 0 
2 2 2 3 0 0 0 0 0 0 0 0 0 0 0 0 0 0 0 0 1 0 3 0 0 3 0 0 0 0 0 3 0 0 0 3 3 0 0 3 1 0 0 3 0 0 0 0 0 0 0 0 0 0 0 3 0 3 0 0
2 2 2 0 0 0 0 0 0 0 0 0 3 0 0 0 0 0 0 0 1 0 3 0 0 0 0 0 0 0 0 3 3 0 0 0 0 0 0 0 1 0 0 0 0 0 0 0 0 0 0 0 0 0 3 0 3 0 0 0
0 0 0 0 0 0 0 0 0 0 0 0 0 0 0 0 0 0 0 0 1 3 0 0 0 0 0 0 0 0 0 3 0 0 0 0 3 0 3 0 1 1 1 1 1 1 1 1 1 1 1 1 1 1 1 1 1 1 1 1
0 0 3 3 0 0 0 0 0 0 0 0 0 0 0 0 0 0 0 0 1 0 0 0 0 0 3 0 0 0 0 0 0 0 0 0 0 0 0 0 1 0 3 0 0 3 0 0 1 0 0 0 0 0 0 0 0 0 3 0
0 0 3 3 3 0 0 0 0 0 3 0 0 0 0 0 0 3 0 0 1 0 0 0 3 0 0 0 0 0 0 0 0 0 0 0 0 3 0 0 1 0 0 3 0 0 0 0 1 3 0 3 0 0 0 0 0 0 0 0
0 3 0 0 3 0 0 0 0 0 0 0 0 0 0 3 0 0 3 0 1 1 1 1 1 1 1 1 1 1 1 1 1 1 1 1 1 1 1 1 1 3 0 3 0 0 0 0 1 0 0 0 0 0 0 0 0 3 0 0
0 0 0 0 0 0 0 0 3 3 0 0 0 0 0 0 0 0 0 0 1 0 3 0 0 0 0 0 0 0 0 1 0 0 3 3 0 0 0 0 1 0 3 0 0 3 0 0 1 0 0 3 0 3 0 0 0 0 0 0
0 0 0 0 0 0 0 3 1 1 1 1 1 1 1 1 1 1 1 1 1 3 0 0 0 0 0 3 0 0 0 1 0 0 0 0 3 0 3 0 1 0 0 3 0 0 3 3 1 0 3 0 0 3 0 0 0 0 0 0
0 3 0 0 0 0 0 0 1 0 3 0 0 0 0 0 0 0 0 0 1 0 0 0 0 0 0 0 0 0 0 1 0 0 3 0 0 0 0 0 1 3 0 0 0 0 0 0 1 0 0 0 0 3 0 0 0 0 0 0
0 0 0 0 0 0 3 0 1 3 0 0 3 0 3 0 0 3 0 3 1 0 0 0 0 0 0 0 0 0 0 1 0 0 0 0 0 0 0 0 1 0 0 0 0 0 0 0 1 0 0 0 0 0 0 0 0 0 0 0
0 0 0 0 0 3 0 0 1 0 0 2 2 2 2 3 0 0 0 0 1 0 0 0 0 0 0 0 0 0 0 1 0 0 0 0 0 0 0 3 1 0 0 0 0 0 0 0 1 0 0 0 0 0 0 3 0 0 0 0
0 0 0 0 0 0 0 0 1 0 0 2 2 2 2 0 0 0 0 3 1 3 0 0 0 3 3 0 0 0 0 1 0 0 0 0 0 3 0 0 1 1 1 1 1 1 1 1 1 1 1 1 1 1 1 1 1 1 1 1
0 0 0 0 0 0 0 0 1 0 0 2 2 2 2 0 0 0 3 0 1 0 0 0 0 0 0 0 0 0 0 1 0 0 0 3 0 0 0 0 1 0 0 0 0 0 0 0 0 0 0 0 0 1 0 0 0 0 3 0
0 0 0 0 0 3 0 0 1 0 0 2 2 2 2 0 0 0 0 0 1 0 0 2 2 2 2 4 2 2 3 1 0 0 0 0 0 3 0 0 1 0 0 0 0 0 3 0 0 0 0 0 0 2 3 0 0 0 0 0
0 0 0 0 0 3 0 0 1 0 0 2 2 2 2 0 0 3 0 0 1 0 0 2 2 4 2 2 2 2 0 1 3 0 3 3 0 0 3 0 1 0 0 0 0 0 0 0 0 0 3 0 0 1 3 0 0 0 0 0
0 0 0 0 3 0 0 0 1 0 0 2 2 2 2 0 0 3 0 0 1 0 0 2 2 2 2 2 2 4 0 1 0 0 0 0 0 3 0 0 1 0 0 0 0 0 0 0 0 0 0 0 3 1 0 0 0 0 0 0
0 0 0 3 0 3 3 0 1 0 0 0 0 0 0 0 0 0 0 0 1 3 3 0 0 0 3 0 0 0 0 1 0 0 0 0 0 0 0 0 1 0 0 0 3 0 0 0 0 0 0 0 0 1 0 0 0 0 0 0
0 0 0 0 0 0 0 0 1 0 3 0 0 0 0 0 0 0 0 3 1 0 0 3 0 3 0 0 0 0 0 1 0 3 0 0 0 0 0 0 1 3 3 3 0 0 0 0 0 0 3 0 3 1 0 0 0 0 0 0
0 0 0 0 0 0 0 0 1 0 0 0 0 0 0 0 0 0 0 0 1 0 0 0 0 0 0 0 0 0 6 1 0 0 0 0 0 0 0 0 1 3 0 0 0 0 0 0 0 0 0 0 0 1 0 0 0 0 0 0
0 1 1 1 1 1 1 1 1 1 1 1 1 1 1 1 1 1 1 1 1 1 1 1 1 1 1 1 1 1 1 1 1 1 1 1 1 1 1 1 1 0 0 0 0 0 0 0 0 0 0 0 0 1 0 0 0 0 0 0
0 0 0 0 0 0 0 0 0 1 0 0 0 0 0 0 0 0 0 0 1 2 2 2 0 0 1 0 0 0 0 0 0 0 0 1 3 3 0 0 1 0 0 0 0 0 0 0 3 0 0 3 0 1 0 0 0 0 0 0
0 0 3 3 0 3 0 0 0 1 3 0 0 0 0 0 0 0 0 0 1 2 4 2 0 3 1 0 0 0 3 3 0 3 0 1 0 0 0 3 1 1 1 1 1 1 1 1 1 1 1 1 1 1 1 1 1 1 1 1
0 0 0 0 0 0 3 3 0 1 0 0 0 0 0 3 0 0 0 0 1 0 2 2 0 0 1 0 0 0 3 3 0 3 0 1 0 3 3 0 1 0 0 0 5 0 1 0 5 0 1 0 5 0 1 0 5 0 1 0
0 0 0 0 0 3 3 0 0 1 0 0 0 0 0 0 0 0 0 0 1 0 0 0 3 0 1 0 0 0 0 0 3 0 3 1 0 0 0 0 1 1 1 1 1 1 1 1 1 1 1 1 1 1 1 1 1 1 1 0
0 0 0 3 0 0 0 0 0 1 6 0 0 3 0 0 0 3 0 3 1 0 0 0 0 0 1 3 0 0 0 0 0 0 0 1 0 0 0 0 1 3 0 0 5 0 1 0 5 3 1 0 7 3 1 0 5 3 1 0
0 0 0 0 3 0 0 0 0 1 1 1 1 1 1 1 1 1 1 1 1 3 0 0 0 0 1 1 1 1 1 1 1 1 1 1 1 1 1 1 1 1 1 1 1 1 1 1 1 1 1 1 1 1 1 1 1 1 1 0 
0 0 0 3 0 0 3 0 0 0 0 0 0 0 0 0 3 3 0 0 1 0 0 0 0 0 1 0 0 0 0 0 3 3 0 0 0 3 0 0 1 0 3 3 0 0 1 0 0 0 1 0 0 0 1 0 0 0 1 0
0 0 0 0 0 0 0 0 0 0 0 0 0 0 3 0 0 0 0 0 1 0 0 0 3 0 1 0 0 0 0 0 0 3 0 0 3 3 0 0 1 0 0 5 5 0 1 0 5 0 1 3 5 0 1 0 5 0 1 0
0 0 0 0 0 0 3 3 0 0 0 3 3 0 0 0 0 0 0 0 1 0 0 0 0 3 1 0 0 0 0 0 3 3 0 0 3 0 0 0 1 1 1 1 1 1 1 1 1 1 1 1 1 1 1 1 1 1 1 0 
0 0 0 0 3 0 0 0 0 0 0 0 0 0 0 0 0 0 0 0 1 0 0 0 0 0 1 0 0 0 3 0 0 0 0 0 0 0 3 3 1 0 0 0 0 0 0 0 3 0 0 0 3 0 6 0 0 3 0 0
2 2 2 2 2 2 2 2 2 2 2 2 2 2 0 0 0 0 0 0 1 0 0 0 0 0 1 0 3 0 0 0 0 0 0 0 0 0 0 3 1 0 0 0 0 0 0 0 0 0 0 0 3 0 0 0 0 0 0 0
2 4 2 2 2 2 2 2 2 2 2 2 2 2 0 0 0 0 0 0 1 1 1 1 1 1 1 1 1 1 1 1 1 1 1 1 1 1 1 1 1 0 0 0 0 0 0 0 0 3 0 0 0 0 0 0 0 0 0 0
2 2 2 2 2 2 2 2 2 2 4 2 2 2 0 0 0 0 3 0 1 0 3 0 0 0 0 0 0 0 3 0 0 0 0 0 0 0 0 0 1 0 0 0 0 0 3 0 0 0 0 3 0 0 0 0 0 0 0 0
2 2 2 2 4 2 2 2 2 2 2 2 2 2 0 0 0 0 0 0 1 0 0 0 0 0 0 0 0 0 0 0 0 0 0 0 0 0 0 0 1 0 0 0 3 0 0 0 3 0 0 0 0 0 0 0 0 0 0 0
2 2 2 2 2 2 2 2 2 2 2 2 2 2 3 0 0 0 0 0 1 0 0 0 0 0 0 0 3 0 0 0 3 0 3 3 0 0 0 0 1 0 0 0 0 0 3 0 0 0 0 3 3 0 0 0 0 0 0 0
2 2 2 2 2 2 2 2 2 2 2 2 2 2 0 0 0 0 0 0 1 0 0 0 0 3 0 0 0 0 0 3 0 0 0 0 0 0 0 0 1 0 0 0 0 0 0 3 0 0 0 0 0 3 0 0 3 0 0 0
2 2 2 2 2 2 2 2 2 2 4 2 2 2 0 3 3 3 0 0 1 3 0 3 0 0 0 0 0 0 0 0 0 0 0 0 0 3 0 0 1 0 3 0 0 0 0 0 0 0 0 0 0 0 0 0 0 0 0 0
2 2 4 2 2 2 2 2 2 2 2 2 2 2 0 0 0 0 0 0 1 0 0 0 0 3 0 0 0 3 0 0 0 0 0 0 0 0 0 0 1 0 0 0 0 0 0 3 0 0 0 0 0 0 0 0 0 0 0 0
2 2 2 2 2 2 2 2 2 2 2 2 2 2 0 0 0 0 0 0 0 0 0 0 0 0 0 0 0 0 0 0 0 0 0 0 0 0 0 0 0 0 0 0 0 0 0 0 0 0 0 0 0 0 0 0 0 0 0 0 
